¨€¨€¨€¨€¨€¨€¨€¨€¨€¨€¨€¨€¨€¨€¨€¨€¨€¨€¨€¨€¨€¨€¨€¨€¨€¨€¨€¨€¡ò¨€¨€¨€¨€¨€¨€¨€¨€¨€¨€¨€¨€¨€¨€¨€¨€¨€¨€¨€¨€¨€¨€¨€¨€¨€¨€¨€¨€¨€¨€¨€
¨€              ¨€                                                                          ¨€                        ¨€
¨€              ¨€                                                                          ¨€                        ¨€
¨€              ¨€                                                                          ¨€                        ¨€
¨€              ¨€                                                                                                    ¨€
¨€                                                                                          ¨€                        ¨€
¨€              ¨€                                                                          ¨€                        ¨€
¨€¨€¨€¨€¨€¨€¨€¨€¨€                                                                          ¨€¨ˆ                      ¨€
¨€                                                                                        ¨ˆ¨ˆ¨ˆ                      ¨€
¨€                                                                                    ¨ˆ¨ˆ¨ˆ¨ˆ¨€¨€¨€  ¨€¨€¨€¨€¨€¨€¨€¨€¨€
¨€                                  ¡ù                                              ¨ˆ¨ˆ¨ˆ¨ˆ                          ¨€
¨€                                ¡ù¡ù¡ù                                            ¨ˆ¨ˆ¨ˆ                            ¨€
¨€                          ¡ù¡ù¡ù¡ù¡ù¡ù¡ù                                          ¨ˆ¨ˆ                              ¨€
¨€                              ¡ù¡ù¡ù¡ù                                            ¨ˆ¨ˆ                              ¨€
¨€                              ¡ù¡ù¡ù                                            ¨ˆ¨ˆ¨ˆ                              ¨€
¨€                                                                                ¨ˆ¨ˆ                                ¨€
¨€                                                                              ¨ˆ¨ˆ                                  ¨€
¨€                                                                            ¨ˆ¨ˆ¨ˆ                                  ¨€
¨€                                                                            ¨ˆ¨ˆ                                    ¨€
¨€¡¡¡¡¡¡¡¡¡¡¡¡¡¡¡¡¡¡¡¡¡¡¡¡¡¡¡¡¡¡¡¡¡¡¡¡¡¡¡¡¡¡¡¡¡¡¡¡¡¡¡¡¡¡¡¡¡¡¡¡¡¡¡¡¡¡¡¡¡¡¡¡¡¡¡¡¨ˆ¨ˆ¡¡¡¡¡¡¡¡¡¡¡¡¡¡¡¡¡¡¡¡¡¡¡¡¡¡¡¡        ¨€
¨€¡¡¡¡¡¡¡¡¡¡¡¡¡¡¡¡¡¡¡¡¡¡¡¡¡¡¡¡¡¡¡¡¡¡¡¡¡¡¡¡¡¡¡¡¡¡¡¡¡¡¡¡¡¡¡¡¡¡¡¡¡¡¡¡¡¡¡¡¡¡¡¡¡¡¡¡¨ˆ¨ˆ¡¡¡¡¡¡¡¡¡¡¡¡¡¡¡¡¡¡¡¡¡¡¡¡¡¡¡¡¡¡¡¡¡¡¡¡¨€
¨€                                                                            ¨ˆ¨ˆ¨ˆ                                  ¨€
¨€                                                                          ¨ˆ¨ˆ¨ˆ¨ˆ                                  ¨€
¨€                                                                          ¨ˆ¨ˆ¨ˆ                                    ¨€
¨€                                                                            ¨ˆ¨ˆ                                    ¨€
¨€                                                                          ¨ˆ¨ˆ¨ˆ                                    ¨€
¨€                                                                          ¡ð¡ð¡ð                                    ¨€
¨€                                                                          ¨ˆ¨ˆ¨ˆ                                    ¨€
¨€                                                                          ¨ˆ¨ˆ¨ˆ                                    ¨€
¨€                                                                          ¨ˆ¨ˆ¨ˆ                                    ¨€
¨€                                                                            ¨ˆ¨ˆ                                    ¨€
¨€                              ¨€¨€¨€  ¨€¨€¨€¨€¨€¨€                          ¨ˆ¨ˆ¨ˆ                                  ¨€
¨€                              ¨€                ¨€                          ¨ˆ¨ˆ¨ˆ                                  ¨€
¨€                              ¨€                ¨€                          ¨ˆ¨ˆ¨ˆ                                  ¨€
¨€                              ¨€                                              ¨ˆ¨ˆ                                  ¨€
¨€                                                ¨€                            ¨ˆ¨ˆ¨ˆ                                ¨€
¨€                              ¨€                ¨€                              ¨ˆ¨ˆ                                ¨€
¨€                              ¨€                ¨€                              ¨ˆ¨ˆ¨ˆ                              ¨€
¨€                              ¨€                ¨€                            ¨ˆ¨ˆ¨ˆ¨ˆ                              ¨€
¨€¨€¨€¨€¨€¨€¨€¨€¨€¨€¨€¨€¨€¨€¨€¨€¨€¨€¨€¨€¨€¨€¨€¨€¨€¨€¨€¨€¨€¨€¨€¨€¨€¨€¨€¨€¨€¨€¨€¨€¨€¨€¨€¨€¨€¨€¨€¨€¨€¨€¨€¨€¨€¨€¨€¨€¨€¨€¨€¨€
